PE                                                                                               PE
#                                                                                                 #
#                                                                                                 #
#                                                                                                 #
#                                                                                                 #
#                                                                                                 #
#                                                                                                 #
#                                                                                                 #
#                                                                                                 #
#                                                                                                 #
#                                                                                                 #
#                                                                                                 #
#                                                                                                 #
#                                                                                                 #
#                                                                                                 #
#                                                                                                 #
#                                                                                                 #
#                                                                                                 #
#                                                                                                 #
#                                                                                                 #
#                                                                                                 #
#                                                                                                 #
#                 P##################################################################E            #
#                 E###################################################################            #
#                                                                                                 #
#                                                                                                 #
#                                                                                                 #
#                                                                                                 #
#                                                                                                 #
#                                                                                                 #
#                                                                                                 #
#                                                                                                 #
#                                                                         p                       #
#                                                                                                 #
#                                                                                                 #
#                                                                                                 #
#                                                                                                 #
#                                                                                                 #
#                                                                                                 #
#                                                                                                 #
#                                                                                                 #
#                                                                                                 #
#                                                                                                 #
#                                                                                                 #
#                                                                                                 #
#                                                                                                 #
#                                                                                                 #
#                                                                                                 #
#                                                                                                 #
#                                                                                                 #
#                                                                                                 #
#                                                                                                 #
#                                                                                                 #
#                                                                                                 #
#                                                                                                 #
#                                                                                                 #
#                                                                                                 #
#                                                                                                 #
#                                                                                                 #
#                                                                                                 #
#                                                                                                 #
#                                                                                                 #
#                                                                                                 #
#                                                                                                 #
#                                                                                                 #
#                                                                                                 #
#                                                                                                 #
#                                                                                                 #
#                                                                                                 #
#                                                                                                 #
#                                                                                                 #
#                                                                                                 #
#                                                                                                 #
#                                                                                                 #
#                                                                                                 #
#                                                                                                 #
#                                                                                                 #
#                                                                                                 #
#                                                                                                 #
#                                                                                                 #
#                                                                                                 #
#                                                                                                 #
#                                                                                                 #
#                                                                                                 #
#                                                                                                 #
#                                                                                                 #
#                                                                                                 #
#                                                                                                 #
#                                               O#######################E                         #
#                                               #                       #                         #
#                                               E########################                         #
#                                                                                                 #
#                                                                                                 #
#                                                                                                 #
#                                                                                                 #
#                                                                                                 #
#                                                                                                 #
E                                                                                                E#
P#################################################################################################E
E##################################################################################################